NO textures/fence.xpm
SO textures/stone.xpm
WE textures/brick.xpm
EA textures/tiles.xpm
F 50, 50, 50
C 0, 150, 150

1111111111111111111111111111111
1000010100000100000000010000001
1111000110110001111101000111111
1000011110111111111111011100001
1011101000000000000111010101101
1010000010111101110000000000001
1000111100010000011111111111011
1010111001010000010000000000001
10001111010000N0000000000111101
1110000000010000010000001000101
1001111111110000010000001010101
1011000100011101110000001010101
1000010001000000000000001010101
1011111111111111111111111010101
1000000000000000000000000010001
1111111111111111111111111111111
